......................................
......................................
......................................
......................................
......#......#........................
......#......#....#...................
......########....#######.............
...........#......#.....#.............
...........#......#.............$.....
...........######.#.............#.....
.......................#........#.....
.......................##########.....
......................................